############
#P....C...E#
#..........#
#....C.....#
############
