############
#P..E...C..#
#....B.....#
#..........#
############
