############
#P.C.S..D..#
#..E..Z.HK.#
#..........#
############
